                  WE          textures/netherrack.xpm
NO             textures/mossy_cobblestone.xpm
SO                       textures/cobblestone.xpm
F 212,200,93
C 19,0,98
EA            textures/cobbled_deepslate.xpm

11111111111111111111111111111111111111111111
1S000000000000000000000000000000000000000001
10000000000000000000000000000000000000000001
11111111111111111111111111111111111111111111