NO textures/nwall.xpm

SO textures/swall.xpm
WE textures/wwall.xpm
EA textures/ewall.xpm

F 220,100,0
C 225,30,0

1111111111111111111111111
1000000000110000000000001
10110000011100N0000000001
100100000000000000000000111111111
111111111011000001110000100000011
100000000011000001110111111111111
11110111111111011100000010101
11110111111111011101010010001
11000000110101011100000010001
10000000000000001100000000001
10000000000000001101010010001
110000011101010111110111100111
11110111 1110101 101111000011
11111111 1111111 111111111111